#########################################
#                                 ^^^^^^#
#                                 ^^^^^^#
#         ^^                      ^^^*^^#
#        ^^^^                           #
#                                       #
#                                       #
*                                       #
#                                       #
#                 ~~~~~~            ^^^^#
#                 ~~~~~~             ^^^#
#                 ~~~~~~               ^#
#                                       #
#~~~                                    #
#~~~~~                                  #
#########################################