#########################################
#                                       #
#                                       #
#                                       #
#      ^^^                              #
#     ^^^^^                             #
#     ^^^^^                    ##########
#      ^^^                                                                     
#                                                                           
#                              ##########
#                                       #
#                        ####           #
#                        #              #
#                     ####              #
#                                       #
#                                       #
#                                       #
#########################################