#########################################
#                                       #
#                                       #
#                                       #
#      ^^^                              #
#     ^^^^^                             #
#     ^^^^^                    ##########
#      ^^^                              *
#                                       *
#                              ##########
#                                       #
#                        ####           #
#                        #              #
#                     ####              #
#                                       #
#~~~~                                   #
#~~~~~                                  #
#########################################