#########################################
#                                 ^^^^^^#
#                                 ^^^^^^#
#                                 ^^^__^#
#                                       #
#                                       #
#                                       #
*                                       #                                 
                                        #                                   
#                                       #
#                                       #
#                 ~~~~~~                #
#                 ~~~~~~                #
#                 ~~~~~~                #
#                                       #
#~~~                                    #
#~~~~~                                  #
#########################################


* - player start there.