^^^^^^^^^^^^^^^^^^^^^^^^^^^^^^^^^^^^^^^^^
^                      ^                ^
^          ^           ^                ^
^         ^^^          ^           PPPPP^
^                                   PPPP^
^                                    PPP^
^         ^                             ^
^         ^             ^^^^            ^
^         ^            ^^^^^^           ^
^^^^^^^^^^^             ^^^^            ^
^                                       ^
^                                       ^
^                                       ^
^                     ^^                ^
^                    ^^^                ^
^^^^^^^^^^^^^^^^^^^^^^^^^^^^^^^^^^^^^*^^^