^^^^^^^^^^^^^^^^^^^^^^^^^^^^^^^^^^^^^^^^^
^                      ^                ^
^          ^           ^                ^
^         ^^^          ^                ^
^          ^           ^^^^^            ^
^                                       ^
^                                       ^
^         ^                             ^
^         ^                             ^
^         ^             ^^^^            ^
^         ^            ^^^^^^           ^
^^^^^^^^^^^             ^^^^            ^
^                                       ^
^                                       ^
^                                       ^
^                     ^^                ^
^                    ^^^              * ^
^^^^^^^^^^^^^^^^^^^^^^^^^^^^^^^^^^^^^^^^^


* - player start there.